未来函数列表:
ZIG - 之字转向
PEAK - 前M个ZIG转向波峰值
PEAKBARS - 前M个ZIG转向波峰到当前距离
TROUGH - 前M个ZIG转向波谷值
TROUGHBARS - 前M个ZIG转向波谷到当前距离
FLATZIG - 归一化之字转向
FLATZIGA - 归一化之字转向
PEAKA - 前M个ZIG转向波峰值
PEAKBARSA - 前M个ZIG转向波峰到当前距离
TROUGHA - 前M个ZIG转向波谷值
ZIGA - 之字转向
FFT - 傅立叶变换函数
BACKSET - 将当前位置到若干周期前的数据设为1
WINNER - 获利盘比例
LWINNER - 近期获利盘比例
PWINNER - 远期获利盘比例
COST - 成本分布情况
CAPITAL - 当前流通股本
DYNAINFO - 即时行情数据
FINANCE - 财务函数
XMA - 返回偏移移动平均,
#MONTH - 跨周期引用
#WEEK - 跨周期引用
#YEAR - 跨周期引用
DHIGH - 返回该不定周期最高价
DOPEN - 返回该不定周期开盘价
DLOW - 返回该不定周期最低价
DCLOSE - 返回该不定周期收盘价
DVOL - 返回该不定周期成交量价
BARSNEXT - 下一次条件成立到当前的周期数
REFX - 引用若干周期后的数据(平滑处理),
REFXV - 引用若干周期后的数据(未作平滑处理)
PEAK - 前M个ZIG转向波峰值
PEAKBARS - 前M个ZIG转向波峰到当前距离